############################
############################
############################
############################
#************##************#
#*####*#####*##*#####*####*#
#*####*#####*##*#####*####*#
#*##******##*##*##******##*#
#*##*####*##****##*####*##*#
#*##*####*##*##*##*####*##*#
#******##*##*##*##*##******#
#*####*##****##****##*####*#
#*####*##*########*##*####*#
#***##*##*########*##*##***#
###*##****************##*###
###*##*##*########*##*##*###
###****##*#******#*##****###
###*##*##*#******#*##*##*###
###*##*##*#******#*##*##*###
###*##*##*########*##*##*###
#***##*##**********##*##***#
#*####*#####*##*#####*####*#
#************##************#
###*#####*########*#####*###
###*#####*########*#####*###
###****##**********##****###
###*##*##*########*##*##*###
###*##*##*########*##*##*###
#***##****##****##****##***#
#*#######*##*##*##*#######*#
#*#######*##*##*##*#######*#
#************##************#
############################
############################
############################