############################
############################
############################
############################
#************##************#
#*##*#######*##*#######*##*#
#*##*#######*##*#######*##*#
#*##******##*##*##******##*#
#*####*##*##****##*##*####*#
#*####*##*##*##*##*##*####*#
#******##*##*##*##*##******#
###*#####****##****#####*###
###*#####*########*#####*###
###****##*########*##****###
###*##*##**********##*##*###
###*##*##*########*##*##*###
###*##*##*#******#*##*##*###
###*##****#******#****##*###
###*#####*#******#*#####*###
###*#####*########*#####*###
###*##****************##*###
###*##*##*########*##*##*###
###*##*##*########*##*##*###
###****##****##****##****###
###*#####*##*##*##*#####*###
###*#####*##*##*##*#####*###
###*******##****##*******###
###*##*#####*##*#####*##*###
###*##*#####*##*#####*##*###
#***##*******##*******##***#
#*####*##*########*##*####*#
#*####*##*########*##*####*#
#******##**********##******#
############################
############################
############################