############################
############################
############################
############################
#**************************#
#*####*##*########*##*####*#
#*####*##*########*##*####*#
#*##***##****##****##***##*#
#*##*####*##*##*##*####*##*#
#*##*####*##*##*##*####*##*#
#******##*##*##*##*##******#
#*####*##*##****##*##*####*#
#*####*##*########*##*####*#
#***##*##*########*##*##***#
###*##****************##*###
###*##*##*########*##*##*###
###*##*##*#******#*##*##*###
###****##*#******#*##****###
###*#####*#******#*#####*###
###*#####*########*#####*###
###**********************###
###*########*##*########*###
###*########*##*########*###
###*##*******##*******##*###
###*##*##*########*##*##*###
###*##*##*########*##*##*###
#******##**********##******#
#*####*#####*##*#####*####*#
#*####*#####*##*#####*####*#
#*##*********##*********##*#
#*##*#####*######*#####*##*#
#*##*#####*######*#####*##*#
#**************************#
############################
############################
############################