  
############################
############################
############################
############################
#*****+******##******+*****#
#*####*#####*##*#####*####*#
#*####*#####*##*#####*####*#
#***+*+***##*##*##***+*+***#
####*####*##+**+##*####*####
####*####*##*##*##*####*####
#***+**##*##*##*##*##**+***#
#*####*##+***##***+##*####*#
#*####*##*########*##*####*#
#***##*##*########*##*##***#
###*##+**+********+**+##*###
###*##*##*########*##*##*###
###*##*##*#******#*##*##*###
###+***##*#******#*##***+###
###*#####*#******#*#####*###
###*#####*########*#####*###
#*****+**+********+**+**+**#
#*####*##*########*##*####*#
#*####*##*########*##*####*#
#*##***##****##****##***##*#
#*##*#######*##*#######*##*#
#***+*****+*+**+****+**+***#
#######*##*######*##*#######
#######*##*######*##*#######
#*******##***##***##*******#
#*##########*##*##########*#
#*##########*##*##########*#
#************##************#
############################
############################
############################