############################
############################
############################
############################
#******##**********##******#
#*####*##*########*##*####*#
#*####*##*########*##*####*#
#*####*##*##****##*##*####*#
#******##*##*##*##*##******#
#*##*####*##*##*##*####*##*#
#*##*####*##*##*##*####*##*#
#*##*********##*********##*#
#*####*##*########*##*####*#
#*####*##*########*##*####*#
#******##**********##******#
###*#####*########*#####*###
###*#####*#******#*#####*###
###****##*#******#*##****###
###*##*##*#******#*##*##*###
###*##*##*########*##*##*###
###*##****************##*###
###*#####*########*#####*###
###*#####*########*#####*###
###**********##**********###
###*#####*##*##*##*#####*###
###*#####*##*##*##*#####*###
###****##*##****##*##****###
###*##*##*##*##*##*##*##*###
###*##*##*##*##*##*##*##*###
#***##*##****##****##*##***#
#*####*##*########*##*####*#
#*####*##*########*##*####*#
#**************************#
############################
############################
############################