############################
############################
############################
############################
#**************************#
#*##########*##*##########*#
#*##########*##*##########*#
#******##****##****##******#
#*####*##*########*##*####*#
#*####*##*########*##*####*#
#*##********************##*#
#*##*####*########*####*##*#
#*##*####*########*####*##*#
#******##*########*##******#
#*####*##**********##*####*#
#*####*##*########*##*####*#
#***##****#******#****##***#
###*##*##*#******#*##*##*###
###*##*##*#******#*##*##*###
###*##*##*########*##*##*###
###****##**********##****###
###*#####*########*#####*###
###*#####*########*#####*###
###**********##**********###
###*########*##*########*###
###*########*##*########*###
###****##**********##****###
###*##*##*########*##*##*###
###*##*##*########*##*##*###
#***##*******##*******##***#
#*#######*##*##*##*#######*#
#*#######*##*##*##*#######*#
#*********##****##*********#
############################
############################
############################