############################
############################
############################
############################
#**************************#
#*####*#####*##*#####*####*#
#*####*#####*##*#####*####*#
#*********##*##*##*********#
###*#####*##*##*##*#####*###
###*#####*##*##*##*#####*###
###****##*##*##*##*##****###
###*##*##**********##*##*###
###*##*##*########*##*##*###
###*##*##*########*##*##*###
#***##****************##***#
#*#######*########*#######*#
#*#######*#******#*#######*#
#*********#******#*********#
#*##*####*#******#*####*##*#
#*##*####*########*####*##*#
#*##***##**********##***##*#
#*####*##*##*##*##*##*####*#
#*####*##*##*##*##*##*####*#
#*##******##*##*##******##*#
#*##*#######*##*#######*##*#
#*##*#######*##*#######*##*#
#**************************#
#*##*####*########*####*##*#
#*##*####*########*####*##*#
#*##***##****##****##***##*#
#*####*##*##*##*##*##*####*#
#*####*##*##*##*##*##*####*#
#*********##****##*********#
############################
############################
############################