############################
############################
############################
############################
#*****+******##******+*****#
#*####*#####*##*#####*####*#
#*####*#####*##*#####*####*#
#***##+***##*##*##***+##***#
###*##*##*##+**+##*##*##*###
###*##*##*##*##*##*##*##*###
###*##*##*##*##*##*##*##*###
###+***##+***##***+##***+###
###*#####*########*#####*###
###*#####*########*#####*###
###+**+**+********+**+**+###
###*##*##*########*##*##*###
###*##*##*#******#*##*##*###
###*##*##*#******#*##*##*###
###*##*##*#******#*##*##*###
###*##*##*########*##*##*###
###*##*##***+**+***##*##*###
###*##*#####*##*#####*##*###
###*##*#####*##*#####*##*###
###+**+##****##****##+**+###
###*##*##*########*##*##*###
###*##*##*########*##*##*###
#***##+**+**+**+**+**+##***#
#*####*#####*##*#####*####*#
#*####*#####*##*#####*####*#
#+****+##****##****##+****+#
#*####*##*########*##*####*#
#*####*##*########*##*####*#
#*****+**+********+**+*****#
############################
############################
############################