############################
############################
############################
############################
#************##************#
#*####*#####*##*#####*####*#
#*####*#####*##*#####*####*#
#*####*#####*##*#####*####*#
#**************************#
#*####*##*########*##*####*#
#*####*##*########*##*####*#
#******##****##****##******#
######*#####*##*#####*######
######*#####*##*#####*######
######*##**********##*######
######*##*########*##*######
######*##*#******#*##*######
######****#******#****######
######*##*#******#*##*######
######*##*########*##*######
######*##**********##*######
######*##*########*##*######
######*##*########*##*######
#************##************#
#*####*#####*##*#####*####*#
#*####*#####*##*#####*####*#
#***##****************##***#
###*##*##*########*##*##*###
###*##*##*########*##*##*###
#******##****##****##******#
#*##########*##*##########*#
#*##########*##*##########*#
#************##************#
############################
############################
############################