############################
############################
############################
############################
#*****+******##******+*****#
#*####*#####*##*#####*####*#
#*####*#####*##*#####*####*#
#*####*#####*##*#####*####*#
#+****+**+**+**+**+**+****+#
#*####*##*########*##*####*#
#*####*##*########*##*####*#
#******##****##****##+*****#
######*#####*##*#####*######
######*#####*##*#####*######
######*##***+**+***##*######
######*##*########*##*######
######*##*#******#*##*######
######+**+#******#+**+######
######*##*#******#*##*######
######*##*########*##*######
######*##**********##*######
######*##*########*##*######
######*##*########*##*######
#*****+**+***##***+**+*****#
#*####*#####*##*#####*####*#
#*####*#####*##*#####*####*#
#***##+**+**+**+**+**+##***#
###*##*##*########*##*##*###
###*##*##*########*##*##*###
#**+***##****##****##***+**#
#*##########*##*##########*#
#*##########*##*##########*#
#***********+##+***********#
############################
############################
############################