############################
############################
############################
############################
#************##************#
#*####*#####*##*#####*####*#
#E####*#####*##*#####*####E#
#*####*#####*##*#####*####*#
#**************************#
#*####*##*########*##*####*#
#*####*##*########*##*####*#
#******##****##****##******#
######*#####.##.#####*######
######*#####.##.#####*######
######*##..........##*######
######*##.########.##*######
######*##.#......#.##*######
######*...#......#...*######
######*##.#......#.##*######
######*##.########.##*######
######*##..........##*######
######*##.########.##*######
######*##.########.##*######
#************##************#
#*####*#####*##*#####*####*#
#*####*#####*##*#####*####*#
#E**##****************##**E#
###*##*##*########*##*##*###
###*##*##*########*##*##*###
#******##****##****##******#
#*##########*##*##########*#
#*##########*##*##########*#
#************##************#
############################
############################
############################