############################
############################
############################
############################
#**************************#
#*####*#####*##*#####*####*#
#E####*#####*##*#####*####E#
#*********##*##*##*********#
###*#####*##*##*##*#####*###
###*#####*##*##*##*#####*###
###****##*##*##*##*##****###
###*##*##**********##*##*###
###*##*##.########.##*##*###
###*##*##.########.##*##*###
#***##*..............*##***#
#*#######.########.#######*#
#*#######.#......#.#######*#
#****.....#......#.....****#
#*##*####.#......#.####*##*#
#*##*####.########.####*##*#
#*##***##..........##***##*#
#*####*##.##.##.##.##*####*#
#*####*##.##.##.##.##*####*#
#*##******##.##.##******##*#
#*##*#######.##.#######*##*#
#*##*#######.##.#######*##*#
#**************************#
#E##*####*########*####*##E#
#*##*####*########*####*##*#
#*##***##****##****##***##*#
#*####*##*##*##*##*##*####*#
#*####*##*##*##*##*##*####*#
#*********##****##*********#
############################
############################
############################