############################
############################
############################
############################
#************##************#
#*####*#####*##*#####*####*#
#*####*#####*##*#####*####*#
#*##******##*##*##******##*#
#*##*####*##****##*####*##*#
#E##*####*##*##*##*####*##E#
#******##*##*##*##*##******#
#*####*##****##****##*####*#
#*####*##.########.##*####*#
#***##*##.########.##*##***#
###*##*..............*##*###
###*##*##.########.##*##*###
###****##.#......#.##****###
###*##*##.#......#.##*##*###
###*##*##.#......#.##*##*###
###*##*##.########.##*##*###
#***##*##..........##*##***#
#*####*#####.##.#####*####*#
#************##************#
###*#####*########*#####*###
###*#####*########*#####*###
###****##**********##****###
###*##*##*########*##*##*###
###*##*##*########*##*##*###
#***##****##****##****##***#
#E#######*##*##*##*#######E#
#*#######*##*##*##*#######*#
#************##************#
############################
############################
############################