############################
############################
############################
############################
#************##************#
#*##*#######*##*#######*##*#
#*##*#######*##*#######*##*#
#E##******##*##*##******##E#
#*####*##*##****##*##*####*#
#*####*##*##*##*##*##*####*#
#******##*##*##*##*##******#
###*#####****##****#####*###
###*#####.########.#####*###
###****##.########.##****###
###.##*##..........##*##.###
###.##*##.########.##*##.###
###.##*##.#......#.##*##.###
###.##*...#......#...*##.###
###.#####.#......#.#####.###
###.#####.########.#####.###
###.##*..............*##.###
###.##*##.########.##*##.###
###.##*##.########.##*##.###
###****##****##****##****###
###*#####*##*##*##*#####*###
###*#####*##*##*##*#####*###
###*******##****##*******###
###*##*#####*##*#####*##*###
###*##*#####*##*#####*##*###
#***##*******##*******##***#
#E####*##*########*##*####E#
#*####*##*########*##*####*#
#******##**********##******#
############################
############################
############################