############################
############################
############################
############################
#******##**********##******#
#*####*##*########*##*####*#
#*####*##*########*##*####*#
#E####*##*##****##*##*####E#
#******##*##*##*##*##******#
#*##*####*##*##*##*####*##*#
#*##*####*##*##*##*####*##*#
#*##*********##*********##*#
#*####*##.########.##*####*#
#*####*##.########.##*####*#
#******##..........##******#
###*#####.########.#####*###
###*#####.#......#.#####*###
###****##.#......#.##****###
###*##*##.#......#.##*##*###
###*##*##.########.##*##*###
###*##*..............*##*###
###*#####.########.#####*###
###*#####.########.#####*###
###**********##**********###
###*#####*##*##*##*#####*###
###*#####*##*##*##*#####*###
###****##*##****##*##****###
###*##*##*##*##*##*##*##*###
###*##*##*##*##*##*##*##*###
#***##*##****##****##*##***#
#*####*##*########*##*####*#
#E####*##*########*##*####E#
#**************************#
############################
############################
############################