############################
############################
############################
############################
#************##************#
#*####*#####*##*#####*####*#
#E####*#####*##*#####*####E#
#*********##*##*##*********#
####*####*##****##*####*####
####*####*##*##*##*####*####
#******##*##*##*##*##******#
#*####*##****##****##*####*#
#*####*##.########.##*####*#
#***##*##.########.##*##***#
###*##*..............*##*###
###*##*##.########.##*##*###
###*##*##.#......#.##*##*###
###****##.#......#.##****###
###*#####.#......#.#####*###
###*#####.########.#####*###
#******..............******#
#*####*##.########.##*####*#
#*####*##.########.##*####*#
#*##***##****##****##***##*#
#*##*#######*##*#######*##*#
#**************************#
#######*##*######*##*#######
#######*##*######*##*#######
#*******##***##***##*******#
#E##########*##*##########E#
#*##########*##*##########*#
#************##************#
############################
############################
############################