############################
############################
############################
############################
#**************************#
#*####*##*########*##*####*#
#*####*##*########*##*####*#
#E##***##****##****##***##E#
#*##*####.##*##*##.####*##*#
#*##*####.##*##*##.####*##*#
#******##.##*##*##.##******#
#*####*##.##****##.##*####*#
#*####*##.########.##*####*#
#***##*##.########.##*##***#
###*##*..............*##*###
###*##*##.########.##*##*###
###*##*##.#......#.##*##*###
###****##.#......#.##****###
###*#####.#......#.#####*###
###*#####.########.#####*###
###*....................*###
###*########.##.########*###
###*########.##.########*###
###*##*******##*******##*###
###*##*##*########*##*##*###
###*##*##*########*##*##*###
#******##**********##******#
#*####*#####*##*#####*####*#
#E####*#####*##*#####*####E#
#*##*********##*********##*#
#*##*#####*######*#####*##*#
#*##*#####*######*#####*##*#
#**************************#
############################
############################
############################