############################
############################
############################
############################
#************##************#
#*####*#####*##*#####*####*#
#E####*#####*##*#####*####E#
#***##****##*##*##****##***#
###*##*##*##****##*##*##*###
###*##*##*##*##*##*##*##*###
###*##*##*##*##*##*##*##*###
###****##****##****##****###
###*#####.########.#####*###
###*#####.########.#####*###
###****..............****###
###.##*##.########.##*##.###
###.##*##.#......#.##*##.###
###.##*##.#......#.##*##.###
###.##*##.#......#.##*##.###
###.##*##.########.##*##.###
###.##*##..........##*##.###
###.##*#####.##.#####*##.###
###.##*#####.##.#####*##.###
###****##****##****##****###
###*##*##*########*##*##*###
###*##*##*########*##*##*###
#***##****************##***#
#*####*#####*##*#####*####*#
#*####*#####*##*#####*####*#
#******##****##****##******#
#*####*##*########*##*####*#
#E####*##*########*##*####E#
#**************************#
############################
############################
############################