############################
############################
############################
############################
#**************************#
#*##########*##*##########*#
#E##########*##*##########E#
#******##****##****##******#
#*####*##*########*##*####*#
#*####*##*########*##*####*#
#*##********************##*#
#*##*####.########.####*##*#
#*##*####.########.####*##*#
#******##.########.##******#
#*####*##..........##*####*#
#*####*##.########.##*####*#
#***##*...#......#...*##***#
###*##*##.#......#.##*##*###
###*##*##.#......#.##*##*###
###*##*##.########.##*##*###
###****##..........##****###
###*#####.########.#####*###
###*#####.########.#####*###
###**********##**********###
###*########*##*########*###
###*########*##*########*###
###****##**********##****###
###*##*##*########*##*##*###
###*##*##*########*##*##*###
#***##*******##*******##***#
#*#######*##*##*##*#######*#
#E#######*##*##*##*#######E#
#*********##****##*********#
############################
############################
############################